Altura,Massa,Idade,Sexo
1.55,50.3,20,1
1.68,65.5,18,1
1.57,55.0,18,2
1.6,78.3,17,1
1.63,45.1,19,2
1.64,90.0,21,2
1.65,80.0,17,1
1.65,75.3,18,2
1.7,60.9,19,1
1.72,83.0,19,1
1.72,72.0,18,1
1.74,65.0,20,2
1.8,82.0,22,1
1.92,91.0,18,2
